000000000000000000000000000000000000000
000000000000000000000000000000000000000
000000000000000000000000000000000000000
000000000000000000000000000000000000000
000000000000000000000000000000000000000
000000000000000030000000000000000000000
000111111111111111111111111111111100000
000000000000000000000000000000000000000
000000000000000000000000000000000000000