000000000000000000000000000000000000000000000000000000
000000000000000000000000110000000000000000000000000000
000000111111111110000000000000000001000000000000000000
111111000001111000000111111000000001000000000000000000
000000000000000000000000000000000001000000000000000000
000000000000000000000000000000000001000000000000000000
000000000300000600000000000200000001000000000000000000
001111111111111111000000011111111111110000000000000000
000000000000000000000000000000000000000000000000000000
000000000000000000000000000000000000000000000111111000
000000000000000000000000000000000000000000000000000000