000000000000000000000000000000000000000000000000000000
000000000000000000000000011000000000000000000000000000
000000000000000000000000000000000001000000000000000000
111111000001111000000111111000000001000000000000000000
000000030000000000000000000000000001000000000000000000
000000600600000000000000000000000001000000000000000000
000000111106600666000000000000000001000000000000000000
001111111111111111000000011111111111110000000000000000
000000000000000000000000000000000000000000000002000000
000000000000000000000000000000000000000000011111100000
000000000000000000000000000000000000000000000000000000