000000000001000000000000006000000000000000000000000000001000
000000000000000000000000011000000000000000000000000000000010
000066000000660000000000000000000000000000000000000000000000
111111000000111000000111111000000000000000000000000000000000
000000030000000000000000000000000000000000000000000000000000
000000000000000000000000000000000000000000000000000000000000
006666600006606666000000066666600666660000000000000000000000
001111111111111111000000011111111111110000000000000000000066
000000000000000000000000000000000000000000000000040000001111
000000000000000000000000000000000000000000000000011111100000
000000000000000000000000000000000000000000000000000000000000